P (400,60)
S (5,3,740,620)

M DDDDDDDDDDDDDDDDDDDD
M DBBBBBDDDDDDDBBBBBBD
M DEEDDBDDDDDDDBDGGDDD
M DEDDDBDGDGDGDBDEEDDD
M DDDDDBDDEDEDDBEEEEDD
M DDDDDBDDEDEDDBEEEEDD
M DDGGDBDDEDEDDBDEEDDD
M DEEEEBDDEDEDDBDEEDDD
M DEEEEBBBBBBBBBDDDDDD
M DDEEDDDEDBDEDDDDDDDD
M DDEEDDDEDBDEDDDDDDDD
M DDDDDDDEDBDEDDDDDDDD
M DDDDDDDEDBDEDDDDDDDD
M DDDDDDDEDBDEDDDDDDDD
M DEDDDDDDDBDDDDDDDDED
M DEEDDDDDDBDDDDDDDEED
M DDDDDDDDDDDDDDDDDDDD