P (400,60)
S (5,3,740,620)

M DDDDDDDDDDDDDDDDDDDD
M DBBBBBDDDDGDGDDDBBBD
M DDDDDBDDDDDDDDDDBDDD
M DDDDDBDDDEEEEEDDBDDD
M DDDDDBDDDEEEEEDDBDDD
M DDDDDBDDDDDDDDDDBDDD
M DDDDDBDDDDDDDDDDBDDD
M DDEEDBDDDDDDDDDDBDDD
M DGEEDBDDDDDDDDDDBDDD
M DEEEDBDDDDDDDDDDBDDD
M DEEEDBDDGDDBBBBBBDDD
M DDEEDBDDEEDBDDDDDDDD
M DDEEDBDEEEDBDEEDDDDD
M DDGGDBDEEEDBDEEDDDDD
M DEDDDBDDDDDBDDDDDDDD
M DEEDDBBBBBBBDDDDDDDD
M DDDDDDDDDDDDDDDDDDDD