P (400,60)
S (5,3,740,620)

M DDDDDDDDDDDDDDDDDDDD
M DBDDDDDDDDDDDDBBBBBD
M DBDDDDDDDDDDDDBDDDDD
M DBDDDDDDDDDDDDBDDDDD
M DBDDDDDDDDDDDDBDDDDD
M DBDDDDDDDDDDDDBDDDDD
M DBDDDDDDDDDDDDBDDDDD
M DBDDDDEEDDDEDDBDDDDD
M DBDDDDEEDDDEDDBDDDDD
M DBDDDDEEDDDEDDBDEEED
M DBDDDDEEDDDEDDBDEEED
M DBBBBDEEDDDEDDBDEEED
M DDDDBDDDDDDDDDBDDDDD
M DDDDBBBBDDDDDDBDDDDD
M DEDDDDDBDDDDDDBDDDED
M DEEDDDDBBBBBBBBDDEED
M DDDDDDDDDDDDDDDDDDDD