P (400,60)
S (5,3,740,620)

M DDDDDDDDDDDDDDDDDDDD
M DBDDDDDDDDDDDDBBBBBD
M DBDDDDDDDDDDDDBDGDDD
M DBGDDDDDDDDDDDBDDDDD
M DBDDDDDDDDDDDDBDDDDD
M DBDDDDDDDDDDDDBDDDDD
M DBDDDDDGDDDDDDBDDDDD
M DBDDDDEEDDDEDDBDDDDD
M DBDDDDEEDDDEDDBDDDDD
M DBDDDDEEGDDEGDBDEEED
M DBDDDDEEDDDEDDBDEEED
M DBBBBDEEDDDEDDBDEEED
M DDDDBDDDDDGDGDBDDDDD
M DDDDBBBBDDDDDDBDDDDD
M DEDDDDDBDDDDDDBDDDED
M DEEDDDDBBBBBBBBDDEED
M DDDDDDDDDDDDDDDDDDDD