P (200,300)
S (5,3,500,500)

M DGEBDDDDDDDDDDDDDDDB
M DDDDDDDDDDDDDDDDDDDD
M DDDDDDDDDDDDDDDDDDDD
M DDDDDDDDDDDDDDDDDDDD
M DDDDDDDDDDDDDDDDDDDD
M DDDDDDDDDDDBBBBBBDDD
M DDDDDDDDDDDBDDDDBDDD
M DDDDDDDDDDDBDDDDBDDD
M DDDDDDDDDDDBBBBBBDDD
M DDDDDDDDDDDDDDDDDDDD
M DDDDDDDDDDDDDDDDDDDD
M DDDDDDDDDDDDDDDDDDDD
M DDDDDDDDDDDDDDDDDDDD
M DDDDDDDDDDDDDDDDDDDD
M DDDDDDDDDDDDDDDDDDDD
M DDDDDDDDDDDDDDDDDDDD
M DDDDDDDDDDDDDDDDDDDD